下表中列举了 String 对象中提供的方法及其描述信息：

方法	描述
anchor()	创建一个 HTML 锚点，即生成一个<a>标签，标签的 name 属性为 anchor() 方法中的参数
big()	用大号字体显示字符串
blink()	显示闪动的字符串
bold()	使用粗体显示字符串
charAt()	返回在指定位置的字符
charCodeAt()	返回指定字符的 Unicode 编码
concat()	拼接字符串
fixed()	以打字机文本显示字符串
fontcolor()	使用指定的颜色来显示字符串
fontsize()	使用指定的尺寸来显示字符串
fromCharCode()	将字符编码转换为一个字符串
indexOf()	检索字符串，获取给定字符串在字符串对象中首次出现的位置
italics()	使用斜体显示字符串
lastIndexOf()	获取给定字符串在字符串对象中最后出现的位置
link()	将字符串显示为链接
localeCompare()	返回一个数字，并使用该数字来表示字符串对象是大于、小于还是等于给定字符串
match()	根据正则表达式匹配字符串中的字符
replace()	替换与正则表达式匹配的子字符串
search()	获取与正则表达式相匹配字符串首次出现的位置
slice()	截取字符串的片断，并将其返回
small()	使用小字号来显示字符串
split()	根据给定字符将字符串分割为字符串数组
strike()	使用删除线来显示字符串
sub()	把字符串显示为下标
substr()	从指定索引位置截取指定长度的字符串
substring()	截取字符串中两个指定的索引之间的字符
sup()	把字符串显示为上标
toLocaleLowerCase()	把字符串转换为小写
toLocaleUpperCase()	把字符串转换为大写
toLowerCase()	把字符串转换为小写
toUpperCase()	把字符串转换为大写
toString()	返回字符串
valueOf()	返回某个字符串对象的原始值